                                         **********                                                 
                                     $****        ****                                              
                                    **.              *** ************                               
                                  ***                  ***          o***                            
                             **   **                                   ***                          
                       ************                                     |**                         
                    ***p                                                 **#                        
                   **.                                                    **                        
                  **                                                      **********                
                ***                                                                ***              
            ****k                                                                    _**            
          ***                                                                          **           
         **        $$$$$                                                                **          
        **       $$     $$ I$$$$$$i$$$a                                                 **          
       $*o      $         $$$$$$$$    $$@                                               **          
       **      $           $)))$        $$$                                             **          
        ** I$$$$    $$$h   $$)$          $$$$$                                         **           
        *$$$0)$    $$$$$$   $$$           $c)$$$                                      *******       
      $$$o)))$$    $$$$$$   $$       $$$$ M$)))&$$p                                **)      o***    
    $$$))))))$$    $$$$$$   $$      $$$$$$ $))))))$$j                                         `**   
  $$$))))))))$$    $$$$$$   $L      $$$$$$ $X))))))8$$                                          **  
 $$))))))))))$$     v$$     $       $$$$$$ $@))))))))$$                                         `** 
$$)))))))))))B$             $?      C$$$$q $k))))))))$$                                          ***
$$))))))))))))$             $$        tf   $))))))))M$$                                          ***
@$$)))))))))))$$           $$$            .$)))))))$$$                                           l**
 $$$)))))))))$$$;         ,$)$            $$)))))$$$                                             n**
   $$$$))))$$$$$$x       j$))p$          #$$$$$$$i                                               ***
      B$$$$h $$))$$     $$))))$$        O$                                                       ** 
        ***  $$))))k$$$#)))))))b$n     $$                                            *a         **  
           *$$)))))))))))))))))))x$$$$$                                              *****    ***   
            $$))))))))))))))))))))))$$                                              .**))******     
           $$)))))))))))))))))))))))$$C                                            \**)))$$         
           $$))))))))))))))))))))))x$z$$$                                         **%))))w$         
          @$m))))))))))))))))))))))$$zzz$$+                          *        '****$$)))))$$        
          $$)))))))))))))))))))))))$$zzzz$$                         ***********     $p))))$$        
          $$)))))))))))))))))))))))$zzzzzB$]                        **))))$$        $$))))@$        
          $$))))))))))))))))))))))C$zzzzB$$   ***                 c**$))))$$        $$)))))$$       
          $$))))))))))))))))))))))$$W$$$$   *** ***\            ***a$$))))$$        $$)))))$$       
          $$))))))))))))))))))))))$$$$*******      *****}  x*****   $$))))$$         $$))))$$       
           $$))))f$$))))$()))))))$$ $$)))))$$         $8****U$$     $$))))#$         $$)))))$$      
            $$b))))))))))))))))$$$  $$)))))$$         $$)))))$$     $$))))x$         $$$$$$$$       
             &$$$o))))))))))$$$$*   $$)))))$$         $$)))))$$     $$$$$$$$          $             
                 $$$$$$$$$$$$       $$)))))$$         $$)))))$$                                     
                                    $$)))))$$         $$)))))$$                                     
                                    $$)))))$$         $$)))))$$            t                        
                                   $$Q)))))$$         $$)))))$$          |tt    \tft ttf tttt       
                                   $$))))))$$         $$)))))x$$         ttttt  tttt ttf tttt       
                                   $$)))))($$         $$))))))$$          ttf                       
                                   $$$$$M)#$          $$))%$$$$$                  t] tn     t       
                                       $$$$$          $$$$$$                                        
